  ______     ___       _______   __       ___          _______   _______  _______  _______ .__   __.   ______  _______ 
 /      |   /   \     |       \ |  |     /   \        |       \ |   ____||   ____||   ____||  \ |  |  /      ||   ____|
|  ,----'  /  ^  \    |  .--.  ||  |    /  ^  \       |  .--.  ||  |__   |  |__   |  |__   |   \|  | |  ,----'|  |__   
|  |      /  /_\  \   |  |  |  ||  |   /  /_\  \      |  |  |  ||   __|  |   __|  |   __|  |  . `  | |  |     |   __|  
|  `----./  _____  \  |  '--'  ||  |  /  _____  \     |  '--'  ||  |____ |  |     |  |____ |  |\   | |  `----.|  |____ 
 \______/__/     \__\ |_______/ |__| /__/     \__\    |_______/ |_______||__|     |_______||__| \__|  \______||_______|
